31
19 13
*--*--*--*--*
|\ | /|\ | /|
| \|/ | \|/ |
*--*--*--*--*
| /|\ | /|\ |
|/ | \|/ | \|
*--*--*--*--*
|\ | /|\ | /|
| \|/ | \|/ |
*--*--*--*--*
| /|\ | /|\ |
|/ | \|/ | \|
*--*--*--*--*
     /|\     
    / | \    
   *--*--*   
  /   |   \  
 /    |    \ 
*-----*-----*